#####
#P  ##
#OXO #
# X# #
#    #
######
